RRRRRRRRRRRRRRRRRRRRRRRRRRRRRRRRRRRRRRRRRRRRRRRRRRRR
R                                                  R
R      L                                           R
R      L                                           R
R      L                                           R
R      L                                           R
R      L                                           R
R      L                                           R
R      L                                           R
R      L                                           R
R      L                                           R
R      L                                           R
R      L                                           R
R                                                  R
R                           L                      R
R                           L                      R
R                           L                      R
R                           L                      R
R                           L                      R
R      LLLLLLLLLL                                  R
R                                                  R
R                                                  R
R                                                  R
R                                                  R
R                                                  R
R                                   LLLLLLLLL      R
R                                                  R
R                                                  R
R       GGGGGGGGGGG                                R
R                                                  R
R                                                  R
RRRRRRRRRRRRRRRRRRRRRRRRRRRRRRRRRRRRRRRRRRRRRRRRRRRR